%%%%%%%%%%
%        %
% P      %
%       F%
%%%%%%%%%%